00,00,00,00,00,00,00,00,00,00,00,00,00,00,00,00,00,00,00,00,00,00,14,15,08,09,10,11,12,13
01,02,03,04,05,06,07,01,02,03,04,05,06,07,01,02,03,04,05,06,07,00,22,23,16,17,18,19,20,21
01,02,03,04,05,06,07,01,02,03,04,05,06,07,01,02,03,04,05,06,07,00,14,15,08,09,10,11,12,13
00,00,00,00,00,00,00,00,00,00,00,00,00,00,00,00,00,00,00,01,02,00,22,23,16,17,18,19,20,21
00,00,00,00,00,00,00,00,00,00,00,00,00,00,00,00,00,00,00,01,02,00,14,15,08,09,10,11,12,13
00,00,00,00,00,00,00,00,00,00,00,00,00,00,00,00,00,00,00,01,02,00,22,23,16,17,18,19,20,21
00,00,00,00,00,00,00,00,00,00,00,00,00,01,02,01,02,01,02,01,02,00,14,15,08,09,10,11,12,13
00,00,00,00,00,00,00,00,00,00,00,00,00,01,02,01,02,01,02,01,02,00,22,23,16,17,18,19,20,21
00,00,00,00,00,00,00,00,00,00,00,00,00,01,02,00,00,00,00,00,00,00,14,15,08,09,10,11,12,13
00,00,00,00,00,00,00,00,00,00,00,00,00,01,02,00,16,17,18,19,20,21,22,23,17,17,18,19,20,21
00,00,00,00,00,00,00,01,02,01,02,01,02,01,02,00,13,09,10,11,12,13,14,15,08,09,10,11,12,13
00,00,00,00,00,00,00,01,02,01,02,01,02,01,02,00,16,17,18,19,20,21,22,23,16,17,18,19,20,21
00,00,00,00,00,00,00,01,02,00,00,00,00,00,00,00,08,09,10,11,12,13,14,15,08,09,10,11,12,13
00,00,00,00,00,00,00,01,02,00,00,00,00,00,00,00,00,00,18,19,20,21,22,23,16,17,18,19,20,21
00,00,00,00,00,00,00,01,02,01,02,01,02,01,02,01,02,00,10,11,12,13,14,15,08,09,10,11,12,13
00,00,00,00,00,00,00,01,02,01,02,01,02,01,02,01,02,00,18,19,20,21,22,23,16,17,18,19,20,21
00,00,00,00,00,00,00,00,00,00,00,00,00,00,00,03,04,00,10,11,12,13,14,15,08,09,10,11,12,13
00,00,00,00,00,00,00,00,00,00,00,00,00,00,00,03,04,00,18,19,20,21,22,23,16,17,18,19,20,21
00,00,00,00,00,00,00,00,00,00,00,00,00,00,00,03,04,00,10,11,12,13,14,15,08,09,10,11,12,13
00,00,00,00,00,00,00,00,00,00,00,00,00,00,00,03,04,00,18,19,20,21,22,23,16,17,18,19,20,21
